8-5
...C....
.O.TT..C
........
..@.....
.......S
