18-7
......STTT.......O
.......TTT..S.....
....T..T..........
................SS
@...............SS
.......TTT.......S
...............CCC